             

NO ./path_to_the_north_texture
SO ./path_to_the_south_texture
WE ./path_to_the_west_texture
EA ./path_to_the_east_texture


F 220,100,0
C 225,30,0

     111     11111111111111 1111111111
     101     1000000000110010000000001
     111     1011000001110000000000111
          1111000000000000000000001
11111111111100000111000000000000111
 111111111  111111111111111111111
100000000011000001110111111111111
11110111111111011100000010001
1111011111   1111011101010010111
11000000111111111100000010001
100000000001    1000110000001111
10000000000011111101010010001
11000001110101011111011110N0111
11110111 1110101 101111010001
11111111 1111111 111111111111
101
111